key	text	tooltip
#Loc PackedFile;1;text/db/ovn_fimir_only_effects.loc		
effects_description_fim_skattach_fimir_magic_res	Magic resistance: %n% for Fimir Warriors, Fimm Guard and Fianna Fimm	true
effects_description_fim_skattach_daemon_damage	Melee attack: %+n for Moor Hounds, Swamp Daemons, Nuckelavees and Daemonomaniacs	true
effects_description_fim_skattach_fianna_damage	Melee attack: %+n for Fianna Fimm	true
effects_description_fim_skattach_fianna_defence	Melee defence: %+n for Fianna Fimm	true
effects_description_fim_skattach_fianna_upkeep	Upkeep: %+n% for Fianna Fimm	true
effects_description_fim_skattach_enable_poison_mist	Ability: "Poison Mist"	true
effects_description_fim_skattach_apprentices_range	Range: %+n%  for Balefiend Apprentices	true
effects_description_fim_skattach_apprentices_damage	Missile damage: %+n% for Balefiend Apprentices	true
effects_description_fim_skattach_enable_summon_bloodletter	Ability: "Summon Swamp Daemons"	true
unit_abilities_additional_ui_effects_localised_text_fim_skattach_summon_swampdaemons	Summons a unit of Swamp Daemons	true
effects_description_fim_skattach_enable_staff_ability	Ability: "Staff of Balor's Eye"	true
effects_description_fim_skattach_fimir_magic_res	Magic resistance: %n% for Fimm Warriors and Fianna Fimm	true
effects_description_enable_fimirach_noble_mount	Unlocks mount: Bog Beast	true
effect_bundles_localised_title_ovn_annoy_chaos_gods_2	Curse of the Dark Gods	true
effect_bundles_localised_description_ovn_annoy_chaos_gods_2	You waste time searching for mere trinkets? True power lies with us fool!	true
effect_bundles_localised_title_ovn_annoy_chaos_gods	Curse of the Dark Gods	true
effect_bundles_localised_description_ovn_annoy_chaos_gods	You do nothing, NOTHING! You don't have enough coin? Here, let me thin your ranks for you!	true
effect_bundles_localised_title_ovn_favour_chaos_gods	Favour of the Dark Gods	true
effect_bundles_localised_description_ovn_favour_chaos_gods	This pleases us, take this gift and bring ruin to the world!	true
effect_bundles_localised_title_ovn_fimir_region_mist	Swirling Mist	true
effect_bundles_localised_description_ovn_fimir_region_mist	Fimir strongholds are seldom seen by outsiders, for they are wreathed in thick mist, a miasma which is magically generated by the Fimir to shield their fortresses from prying eyes, and themselves from the harsh glare of the sun.	true
unit_abilities_tooltip_text_ovn_chs_dark_god_blessing	This army has gained the favour of the Dark Ones, wreak havoc and they will knit your gaping bloody wounds.	true
unit_abilities_onscreen_name_ovn_chs_dark_god_blessing	Blessings of the Dark Ones	true
effects_description_ovn_chs_dark_god_blessing	Passive ability: "Dark Ones Blessing"	true
effects_description_ovn_no_add_army_upkeep_dummy	Does not pay additional Army Upkeep	true
effect_bundles_localised_title_wh2_main_lord_trait_nor_servants_of_fimulneid	From The Mist They Come	true
effect_bundles_localised_description_wh2_main_lord_trait_nor_servants_of_fimulneid	We come for your women folk, resistance is futile!	true
effects_description_wh2_main_effect_enable_nor_vanguard_monsters	Attribute: Vanguard Deployment for Skin Wolves, Fimir Warlord & all Fimir units	true
effects_description_wh2_main_effect_nor_fimir_trolls_rank7_melee_damage	Weapon strength: %+n% for Norscan Trolls & all Fimir units {{tr:rank7}}	true
effects_description_wh2_main_effect_nor_fimir_trolls_rank7_charge_bonus	Charge bonus: %+n for Norscan Trolls & all Fimir units {{tr:rank7}}	true
effects_description_wh2_main_effect_nor_fimir_trolls_rank7_melee_attack	Melee attack: %+n for Norscan Trolls & all Fimir units {{tr:rank7}}	true
effects_description_wh2_dlc11_effect_skill_melee_attack_increase_nor_fimir_giant_mammoth	Melee attack: %+n for all Fimir, Norscan Giant, Feral Mammoth, and War Mammoth units	true
effects_description_wh_dlc08_effect_tech_recruitment_cost_reduction_trolls_fimirs	Recruitment cost: %+n% for all Norscan Troll, Norscan Ice Troll & all Fimir units	true
effects_description_wh2_dlc11_effect_skill_melee_defence_increase_nor_fimir_giant_mammoth	Melee defence: %+n for all Fimir, Norscan Giant, Feral Mammoth, and War Mammoth units	true
effects_description_wh_dlc08_effect_skill_upkeep_reduction_trolls_fimirs	Upkeep: %+n% for all Norscan Troll, Norscan Ice Troll & all Fimir units	true
effects_description_wh_dlc08_effect_skill_morale_increase_fimirs	Leadership: %+n for all Fimir units	true
effects_description_wh_dlc08_effect_tech_melee_damage_increase_trolls_fimirs	Weapon strength: %+n% for all Norscan Troll, Norscan Ice Troll & all Fimir units	true
effects_description_wh_dlc08_effect_tech_unit_stat_melee_defence_fimirs	Melee defence: %+n for all Fimir units	true
effects_description_wh_dlc08_effect_skill_replenishment_trolls_fimirs	Casualty replenishment rate: %+n% for all Norscan Troll, Norscan Ice Troll & all Fimir units	true
effects_description_wh_dlc08_effect_tech_charge_speed_increase_trolls_fimirs	Charge bonus: %+n% for all Norscan Troll, Norscan Ice Troll & all Fimir units	true
effects_description_elo_demons_papa_nurgle	Ward Save: %+n% for Plaguebearers	true
effects_description_elo_demons_khoooorne	Passive Ability: "Berserk" for Bloodletters 	true
effects_description_elo_champions_chaos_r7_wps	Weapon Strength: %+n% for all Chaos Warriors, Chosen, Marauders, Chaos Spawn, Forsaken and Demon units {{tr:rank7}}	true
effects_description_elo_champions_chaos_r7_md	Melee Defence: %+n for all Chaos Warriors, Chosen, Marauders, Chaos Spawn, Forsaken and Demon units {{tr:rank7}}	true
effects_description_elo_champions_chaos_r7_magicres	Magic Resistance: %+n% for all Chaos Warriors, Chosen, Marauders, Chaos Spawn, Forsaken and Demon units {{tr:rank7}}	true
effects_description_ovn_campaign_enable_name_dirach		true
effects_description_elo_swamp_ain	Anti-Infantry: %+n for Fenbeasts and Fenhulks	true
effects_description_elo_swamp_xp	Recruitment Rank: %+n for Fenbeasts and Fenhulks	true
effects_description_elo_swamp_ward	Ward Save: %+n% for Fenbeasts and Fenhulks	true
effects_description_elo_fimir_rusher_sp	Speed: %+n% for Hounds, Nuckelavees and Bog Raiders	true
effects_description_elo_fimir_rusher_ch	Charge Bonus: %+n for Hounds, Nuckelavees and Bog Raiders	true
effects_description_elo_fimir_first_wave_ma	Melee Attack: %+n for Boglars, Shearls and Fimm Deathquests	true
effects_description_elo_fimir_first_wave_wps	Weapon Strength: %+n% for Boglars, Shearls and Fimm Deathquests	true
effects_description_elo_fimir_bog_monsters_wps	Weapon Strength: %+n% for Fenbeasts, Bog Octopuses and Swamp Daemons	true
effects_description_elo_fimir_bog_monsters_md	Melee Defence: %+n for Fenbeasts, Bog Octopuses and Swamp Daemons	true
effects_description_elo_fimir_swamp_warriors_ma	Melee Attack: %+n for Fimm Warriors, Fianna Fimm and Fimm Mistmors	true
effects_description_elo_fimir_swamp_warriors_md	Melee Defence: %+n for Fimm Warriors, Fianna Fimm and Fimm Mistmors	true
effects_description_elo_fimir_giants_fen_sp	Speed: %+n% for Chaos Giants, Fenhulks and Daemonomaniacs	true
effects_description_elo_fimir_giants_fen_ma	Melee Attack: %+n for Chaos Giants, Fenhulks and Daemonomaniacs	true
effects_description_elo_fimir_r7_warriors_md	Melee Defence: %+n for Boglars, Shearls, Fimm Deathquests, Fimm Warriors and Fianna Fimm {{tr:rank7}}	true
effects_description_elo_fimir_r7_warriors_armour	Armour: %+n for Boglars, Shearls, Fimm Deathquests, Fimm Warriors and Fianna Fimm {{tr:rank7}}	true
effects_description_elo_fimir_r7_warriors_phyres	Physical Resistance: %+n% for Boglars, Shearls, Fimm Deathquests, Fimm Warriors and Fianna Fimm {{tr:rank7}}	true
effects_description_elo_fimir_r7_auxillaries_missres	Missile Resistance: %+n% for Fenbeasts, Chaos Furies and Swamp Daemons {{tr:rank7}}	true
effects_description_elo_fimir_r7_auxillaries_md	Melee Defence: %+n for Fenbeasts, Chaos Furies and Swamp Daemons {{tr:rank7}}	true
effects_description_elo_fimir_r7_auxillaries_morale	Leadership: %+n for Fenbeasts, Chaos Furies and Swamp Daemons {{tr:rank7}}	true
effects_description_elo_fimir_r7_fast_wps	Weapon Strength: %+n% for Hounds, Nuckelavees and Bog Raiders {{tr:rank7}}	true
effects_description_elo_fimir_r7_fast_ma	Melee Attack: %+n for Hounds, Nuckelavees and Bog Raiders {{tr:rank7}}	true
effects_description_elo_fimir_r7_fast_ch	Charge Bonus: %+n for Hounds, Nuckelavees and Bog Raiders {{tr:rank7}}	true
effects_description_elo_fimir_r7_giants_ward	Ward Save: %+n% for Chaos Giants, Fenhulks, Fimm Mistmors, Daemonomaniacs, Bog Octopuses and Eye Oculus of Balor {{tr:rank7}}	true
effects_description_elo_fimir_r7_giants_wps	Weapon Strength: %+n% for Chaos Giants, Fenhulks, Fimm Mistmors, Daemonomaniacs, Bog Octopuses and Eye Oculus of Balor {{tr:rank7}}	true
effects_description_elo_fimir_r7_giants_armour	Armour: %+n for Chaos Giants, Fenhulks, Fimm Mistmors, Daemonomaniacs, Bog Octopuses and Eye Oculus of Balor {{tr:rank7}}	true
effects_description_fimir_slaves_upkeep	Upkeep: %+n% for Boglars and Shearls	true
effects_description_fimir_slaves_cost	Recruitment Cost: %+n% for Boglars and Shearls	true
effects_description_fimir_warrior_elite_xp	Recruitment Rank: %+n for Fimm Warriors and Fianna Fimm	true
effects_description_fimir_warrior_elite_md	Melee Defence: %+n for Fimm Warriors and Fianna Fimm	true
effects_description_fimir_warrior_elite_up	Upkeep: %+n% for Fimm Warriors and Fianna Fimm	true
effects_description_fimir_warrior_elite_cost	Recruitment Cost: %+n% for Fimm Warriors and Fianna Fimm	true
effects_description_fimir_untamed_monsters_frenzy	Passive Ability: "Frenzy" for Chaos Giants and Fimm Mistmors	true
effects_description_fimir_untamed_monsters_guerilla	Enables Guerilla Deployment for Chaos Giants and Fimm Mistmors	true
effects_description_fimir_untamed_monsters_rampage	Enables Rampage for Chaos Giants and Fimm Mistmors	true
effects_description_elo_fimir_witness_me	Ability: "Under the Eyes of the Gods"	true
effects_description_fimir_warrior_elite_wps	Weapon Strength: %+n% for Fimm Warriors and Fianna Fimm	true
effects_description_fimir_warrior_elite_armour	Armour: %+n for Fimm Warriors and Fianna Fimm	true
effects_description_dlc08_nor_fimirs_ma	Melee Attack: %+n for all Fimir units	true
effects_description_dlc08_nor_fimirs_up	Upkeep: %+n% for all Fimir units	true
effects_description_elo_fimir_shearl_ma	Melee Attack: %+n for Shearls, Shearl Scouts and Fimm Deathquests	true
effects_description_elo_fimir_shearl_md	Melee Defence: %+n for Shearls, Shearl Scouts and Fimm Deathquests	true
effects_description_elo_fimir_useful_shearls_wps	Weapon Strength: %+n% for Shearl Scouts and Fimm Deathquests	true
effects_description_elo_fimir_useful_shearls_charge	Charge: %+n% for Shearl Scouts and Fimm Deathquests	true
effects_description_elo_fimir_useful_shearls_ammo	Ammunition: %+n% for Shearl Scouts	true
effects_description_elo_fimir_useful_shearls_mdmg	Missile Damage: %+n% for Shearl Scouts	true
effects_description_elo_fimir_apprentices_mdmg	Missile Damage: %+n% for Balefiend Apprentices	true
effects_description_elo_fimir_apprentices_reload	Reload: %+n% for Balefiend Apprentices	true
effects_description_elo_fimir_apprentices_range	Range: %+n% for Balefiend Apprentices	true
effects_description_elo_low_level_swamp_dwellers_rep	Replenishment: %+n% for Boglars and Hound units	true
effects_description_elo_low_level_swamp_dwellers_speed	Speed: %+n% for Boglars and Hound units	true
effects_description_elo_low_level_swamp_dwellers_vsinf	Bonus vs. Infantry: %+n for Boglars and Hound units	true
effects_description_elo_fimir_trolls_charge	Charge: %+n% for Swamp Daemons and Fimm Mistmors	true
effects_description_elo_fimir_trolls_ma	Melee Attack: %+n for Swamp Daemons and Fimm Mistmors	true
effects_description_elo_fimir_trolls_armour	Armour: %+n for Swamp Daemons and Fimm Mistmors	true
effects_description_elo_swamp_riders_speed	Speed: %+n% for Nuckelavees and Bog Raiders	true
effects_description_elo_swamp_riders_vsinf	Bonus vs. Infantry: %+n for Nuckelavees and Bog Raiders	true
effects_description_elo_swamp_riders_charge	Charge: %+n% for Nuckelavees and Bog Raiders	true
effects_description_elo_fen_big_dwellers_xp	Recruitment Rank: %+n for Chaos Giants, Eye Oculus of Balor and Daemonomaniacs	true
effects_description_elo_fen_big_dwellers_up	Upkeep: %+n% for Chaos Giants, Eye Oculus of Balor and Daemonomaniacs	true
effects_description_elo_fen_big_dwellers_ward	Ward Save: %+n% for Chaos Giants, Eye Oculus of Balor and Daemonomaniacs	true
effects_description_elo_fen_monster_rulers_matt	Melee Attack: %+n for Boglars, Moor Hounds, Swamp Daemons, Nuckelavees, Bog Raiders and Chaos Giants	true
effects_description_elo_fen_monster_rulers_morale	Leadership: %+n for Boglars, Moor Hounds, Swamp Daemons, Nuckelavees, Bog Raiders and Chaos Giants	true
effects_description_elo_fen_monster_rulers_resmis	Missile Resistance: %+n% for Boglars, Moor Hounds, Swamp Daemons, Nuckelavees, Bog Raiders and Chaos Giants	true
effects_description_elo_fen_monster_rulers_cost	Recruitment Cost: %+n% for Boglars, Moor Hounds, Swamp Daemons, Nuckelavees, Bog Raiders and Chaos Giants	true
effects_description_elo_fen_lord_heroes	Abilities: "Warpfireball" and "Windblast" for all Lords and Heroes	true
effects_description_elo_fen_lord_heroes_ward	Ward Save: %+n% for all Lords and Heroes	true
effects_description_elo_charge_trolls_fim	Charge Bonus: %+n% for all Troll and Fimir units	false
effects_description_elo_cost_trolls_fim	Recruitment Cost: %+n% for all Troll and Fimir units	false
effects_description_elo_wps_trolls_fim	Weapon Strength: %+n% for all Troll and Fimir units	false
effects_description_albion_monsters_fen_mdef	Melee Defence: %+n for Fenbeasts and Fenhulks	true
effects_description_albion_monsters_fen_mattk	Melee Attack: %+n for Fenbeasts and Fenhulks	true
effects_description_enable_wh_dlc08_unit_passive_from_the_mist	Ability: "From the Mists" for all units	true
effects_description_ovn_effect_enable_attribute_stalk_bog_octopus	Attribute: Stalk for Bog Octopus units	true
effects_description_ovn_fim_effect_agent_cap_increase_elo_boglar_shaman	Hero capacity: %+n for Boglar Shamans	false
effects_description_ovn_fim_effect_agent_enable_recruitment_elo_boglar_shaman	Unlocks [[img:icon_hero]][[/img]]Hero recruitment: Boglar Shaman	false
effects_description_ovn_fim_effect_agent_xp_increase_elo_boglar_shaman	Hero recruit rank: %+n for Boglar Shamans	false
effects_description_ovn_fim_effect_agent_enable_recruitment_finmor	Unlocks [[img:icon_hero]][[/img]]Hero recruitment: Fimm Finmor	false
effects_description_ovn_fim_effect_agent_cap_increase_champion_finmor	Hero capacity: %+n for Fimm Finmor	false
effects_description_ovn_fim_effect_agent_xp_increase_finmor	Hero recruit rank: %+n for Fimm Finmor	false
effects_description_ovn_fim_effect_agent_recruitment_xp_dignitary_fimir_balefiend	Hero recruit rank: %+n for Fimir Balefiends	false
effects_description_ovn_fim_effect_agent_enable_recruitment_dignitary_fimir_balefiend	Unlocks [[img:icon_hero]][[/img]]Hero recruitment: Fimir Balefiends	false
effects_description_ovn_fim_effect_agent_cap_increase_dignitary_fimir_balefiend	Hero capacity: %+n for Fimir Balefiends	false
