key	text	tooltip
#Loc;1;text/db/rhox_grudgebringer_effect_bundle.loc		
effect_bundles_localised_title_rhox_grudgebringer_piece_of_eight_1	Unlocks Regiment of Renown: Ragnar's Wolves	false
effect_bundles_localised_description_rhox_grudgebringer_piece_of_eight_1	Unlocks Regiment of Renown: Ragnar's Wolves	false
effect_bundles_localised_title_rhox_grudgebringer_piece_of_eight_2	Unlocks Regiment of Renown: Eusebio's Flagellants	false
effect_bundles_localised_description_rhox_grudgebringer_piece_of_eight_2	Unlocks Regiment of Renown: Eusebio's Flagellants	false
effect_bundles_localised_title_rhox_grudgebringer_piece_of_eight_3	Unlocks Regiment of Renown: Azguz Bloodfist's Dwarf Warriors	false
effect_bundles_localised_description_rhox_grudgebringer_piece_of_eight_3	Unlocks Regiment of Renown: Azguz Bloodfist's Dwarf Warriors	false
effect_bundles_localised_title_rhox_grudgebringer_piece_of_eight_4	Unlocks Regiment of Renown: Dargrimm Firebeard's Dwarf Warriors	false
effect_bundles_localised_description_rhox_grudgebringer_piece_of_eight_4	Unlocks Regiment of Renown: Dargrimm Firebeard's Dwarf Warriors	false
effect_bundles_localised_title_rhox_grudgebringer_piece_of_eight_5	Unlocks Regiment of Renown: Urblab Rotgut's Mercenary Ogres	false
effect_bundles_localised_description_rhox_grudgebringer_piece_of_eight_5	Unlocks Regiment of Renown: Urblab Rotgut's Mercenary Ogres	false
effect_bundles_localised_title_rhox_grudgebringer_piece_of_eight_6	Unlocks Regiment of Renown: Elrod's Wood Elf Glade Guards	false
effect_bundles_localised_description_rhox_grudgebringer_piece_of_eight_6	Unlocks Regiment of Renown: Elrod's Wood Elf Glade Guards	false
effect_bundles_localised_title_rhox_grudgebringer_piece_of_eight_7	Unlocks Regiment of Renown: Galed's Elf Archers	false
effect_bundles_localised_description_rhox_grudgebringer_piece_of_eight_7	Unlocks Regiment of Renown: Galed's Elf Archers	false
effect_bundles_localised_title_rhox_grudgebringer_piece_of_eight_8	Unlocks Regiment of Renown: Helmgart Bowmen	false
effect_bundles_localised_description_rhox_grudgebringer_piece_of_eight_8	Unlocks Regiment of Renown: Helmgart Bowmen	false
effect_bundles_localised_title_rhox_grudgebringer_piece_of_eight_9	Unlocks Regiment of Renown: Keeler's Longbows	false
effect_bundles_localised_description_rhox_grudgebringer_piece_of_eight_9	Unlocks Regiment of Renown: Keeler's Longbows	false
effect_bundles_localised_title_rhox_grudgebringer_piece_of_eight_10	Unlocks Regiment of Renown: Black Avengers	false
effect_bundles_localised_description_rhox_grudgebringer_piece_of_eight_10	Unlocks Regiment of Renown: Black Avengers	false
effect_bundles_localised_title_rhox_grudgebringer_piece_of_eight_11	Unlocks Regiment of Renown: Carlsson's Guard	false
effect_bundles_localised_description_rhox_grudgebringer_piece_of_eight_11	Unlocks Regiment of Renown: Carlsson's Guard	false
effect_bundles_localised_title_rhox_grudgebringer_piece_of_eight_12	Unlocks Regiment of Renown: Carlsson's Cavalry	false
effect_bundles_localised_description_rhox_grudgebringer_piece_of_eight_12	Unlocks Regiment of Renown: Carlsson's Cavalry	false
effect_bundles_localised_title_rhox_grudgebringer_piece_of_eight_13	Unlocks Regiment of Renown: Vannheim's 75th	false
effect_bundles_localised_description_rhox_grudgebringer_piece_of_eight_13	Unlocks Regiment of Renown: Vannheim's 75th	false
effect_bundles_localised_title_rhox_grudgebringer_piece_of_eight_14	Unlocks Regiment of Renown: Treeman Knarlroot	false
effect_bundles_localised_description_rhox_grudgebringer_piece_of_eight_14	Unlocks Regiment of Renown: Treeman Knarlroot	false
effect_bundles_localised_title_rhox_grudgebringer_piece_of_eight_15	Unlocks Regiment of Renown: Treeman Gnarl Fist	false
effect_bundles_localised_description_rhox_grudgebringer_piece_of_eight_15	Unlocks Regiment of Renown: Treeman Gnarl Fist	false
effect_bundles_localised_title_rhox_grudgebringer_piece_of_eight_16	Unlocks Regiment of Renown: Uter Blomkwist's Imperial Mortar	false
effect_bundles_localised_description_rhox_grudgebringer_piece_of_eight_16	Unlocks Regiment of Renown: Uter Blomkwist's Imperial Mortar	false
effect_bundles_localised_title_rhox_grudgebringer_piece_of_eight_17	Unlocks Regiment of Renown: Countess Guard	false
effect_bundles_localised_description_rhox_grudgebringer_piece_of_eight_17	Unlocks Regiment of Renown: Countess Guard	false
effect_bundles_localised_title_rhox_grudgebringer_piece_of_eight_18	Unlocks Regiment of Renown: Dieter Schaeffer Carroburg Greatswords	false
effect_bundles_localised_description_rhox_grudgebringer_piece_of_eight_18	Unlocks Regiment of Renown: Dieter Schaeffer Carroburg Greatswords	false
effect_bundles_localised_title_rhox_grudgebringer_piece_of_eight_19	Unlocks Regiment of Renown: Jurgen Muntz Outlaw Infantry	false
effect_bundles_localised_description_rhox_grudgebringer_piece_of_eight_19	Unlocks Regiment of Renown: Jurgen Muntz Outlaw Infantry	false
effect_bundles_localised_title_rhox_grudgebringer_piece_of_eight_20	Unlocks Regiment of Renown: Boris von Raukov 4th Nuln Halberdiers	false
effect_bundles_localised_description_rhox_grudgebringer_piece_of_eight_20	Unlocks Regiment of Renown: Boris von Raukov 4th Nuln Halberdiers	false
effect_bundles_localised_title_rhox_grudgebringer_piece_of_eight_21	Unlocks Regiment of Renown: Stephan Weiss Outlaw Pistoliers	false
effect_bundles_localised_description_rhox_grudgebringer_piece_of_eight_21	Unlocks Regiment of Renown: Stephan Weiss Outlaw Pistoliers	false
effect_bundles_localised_title_rhox_grudgebringer_piece_of_eight_22	Unlocks Regiment of Renown: Darius Flugenheim's Imperial Cannons 	false
effect_bundles_localised_description_rhox_grudgebringer_piece_of_eight_22	Unlocks Regiment of Renown: Darius Flugenheim's Imperial Cannons 	false
effect_bundles_localised_title_rhox_grudgebringer_piece_of_eight_23	Unlocks Regiment of Renown: Tristan de la Tour's Grail Knights	false
effect_bundles_localised_description_rhox_grudgebringer_piece_of_eight_23	Unlocks Regiment of Renown: Tristan de la Tour's Grail Knights	false
effect_bundles_localised_title_rhox_grudgebringer_piece_of_eight_24	Unlocks Regiment of Renown: Bertrand le Grande's Knights of the Realm	false
effect_bundles_localised_description_rhox_grudgebringer_piece_of_eight_24	Unlocks Regiment of Renown: Bertrand le Grande's Knights of the Realm	false
effect_bundles_localised_title_rhox_grudgebringer_lh_reward_bundle_1	Ludwig von Uberdorf will join your forces	false
effect_bundles_localised_description_rhox_grudgebringer_lh_reward_bundle_1	Ludwig von Uberdorf will join your forces	false
effect_bundles_localised_title_rhox_grudgebringer_lh_reward_bundle_2	Ceridan will join your forces	false
effect_bundles_localised_description_rhox_grudgebringer_lh_reward_bundle_2	Ceridan will join your forces	false
effect_bundles_localised_title_rhox_grudgebringer_lh_reward_bundle_3	Vladimir Stormbringer will join your forces	false
effect_bundles_localised_description_rhox_grudgebringer_lh_reward_bundle_3	Vladimir Stormbringer will join your forces	false
effect_bundles_localised_title_rhox_grudgebringer_lh_reward_bundle_4	Engrol Goldtongue will join your forces	false
effect_bundles_localised_description_rhox_grudgebringer_lh_reward_bundle_4	Engrol Goldtongue will join your forces	false
effect_bundles_localised_title_rhox_grudgebringer_lh_reward_bundle_5	Matthias will join your forces	false
effect_bundles_localised_description_rhox_grudgebringer_lh_reward_bundle_5	Matthias will join your forces	false
effect_bundles_localised_title_rhox_grudgebringer_lh_reward_bundle_6	Luther Flamestrike will join your forces	false
effect_bundles_localised_description_rhox_grudgebringer_lh_reward_bundle_6	Luther Flamestrike will join your forces	false
effect_bundles_localised_title_rhox_grudge_debt_money	Owes Debt to the money lenders	false
effect_bundles_localised_description_rhox_grudge_debt_money	You owe a debt to the money lenders and are paying a bit of the coin turn by turn	false
