key	text	tooltip
#Loc;1;text/db/ovn_araby_only_land_units.loc		
land_units_onscreen_name_ovn_arb_art_grand_bombard	Grand Bombard	true
land_units_onscreen_name_ovn_arb_art_grand_bombard_ror	Howling Basilisk Bombard (Grand Bombard)	true
land_units_onscreen_name_ovn_arb_cav_arabyan_knights	Arabyan Knights	true
land_units_onscreen_name_ovn_arb_cav_arabyan_knights_ror	Al Muktar's Desert Dogs	true
land_units_onscreen_name_ovn_arb_cav_archer_camels	Camel Archers	true
land_units_onscreen_name_ovn_arb_cav_bedouin_scouts	Desert Riders	true
land_units_onscreen_name_ovn_arb_cav_flying_carpets	Flying Carpets	true
land_units_onscreen_name_ovn_arb_cav_flying_carpets_ror	Naffatun of Saghash (Flying Carpets)	true
land_units_onscreen_name_ovn_arb_cav_jezzail_camels	Camel Jezzails	true
land_units_onscreen_name_ovn_arb_cav_lancer_camels	Camel Lancers	true
land_units_onscreen_name_ovn_arb_cav_sipahis	Camel Cataphracts	true
land_units_onscreen_name_ovn_arb_cav_sipahis_ror	Sipahis of Copher (Camel Cataphracts)	true
land_units_onscreen_name_ovn_arb_cha_champion_0	Emir	true
land_units_onscreen_name_ovn_arb_cha_champion_1	Emir	true
land_units_onscreen_name_ovn_arb_cha_champion_2	Emir	true
land_units_onscreen_name_ovn_arb_cha_champion_3	Emir	true
land_units_onscreen_name_ovn_arb_cha_champion_wazar_0	Wazar the Cruel	true
land_units_onscreen_name_ovn_arb_cha_champion_wazar_1	Wazar the Cruel	true
land_units_onscreen_name_ovn_arb_cha_champion_wazar_2	Wazar the Cruel	true
land_units_onscreen_name_ovn_arb_cha_champion_wazar_3	Wazar the Cruel	true
land_units_onscreen_name_ovn_arb_cha_fatandira_0	Fatandira	true
land_units_onscreen_name_ovn_arb_cha_fatandira_1	Fatandira	true
land_units_onscreen_name_ovn_arb_cha_fatandira_2	Fatandira	true
land_units_onscreen_name_ovn_arb_cha_golden_magus_0	The Golden Magus	true
land_units_onscreen_name_ovn_arb_cha_golden_magus_1	The Golden Magus	true
land_units_onscreen_name_ovn_arb_cha_golden_magus_2	The Golden Magus	true
land_units_onscreen_name_ovn_arb_cha_magician_desert_0	Magician (Djinn)	true
land_units_onscreen_name_ovn_arb_cha_magician_desert_1	Magician (Djinn)	true
land_units_onscreen_name_ovn_arb_cha_magician_desert_2	Magician (Djinn)	true
land_units_onscreen_name_ovn_arb_cha_magician_fire_0	Magician (Fire)	true
land_units_onscreen_name_ovn_arb_cha_magician_fire_1	Magician (Fire)	true
land_units_onscreen_name_ovn_arb_cha_magician_fire_2	Magician (Fire)	true
land_units_onscreen_name_ovn_arb_cha_magician_heavens_0	Magician (Heavens)	true
land_units_onscreen_name_ovn_arb_cha_magician_heavens_1	Magician (Heavens)	true
land_units_onscreen_name_ovn_arb_cha_magician_heavens_2	Magician (Heavens)	true
land_units_onscreen_name_ovn_arb_cha_magician_life_0	Magician (Life)	true
land_units_onscreen_name_ovn_arb_cha_magician_life_1	Magician (Life)	true
land_units_onscreen_name_ovn_arb_cha_magician_life_2	Magician (Life)	true
land_units_onscreen_name_ovn_arb_cha_nomad_0	Hashishin	true
land_units_onscreen_name_ovn_arb_cha_nomad_0_summoned	Hashishin	true
land_units_onscreen_name_ovn_arb_cha_sheikh_0	Sheikh	true
land_units_onscreen_name_ovn_arb_cha_sheikh_1	Sheikh	true
land_units_onscreen_name_ovn_arb_cha_sheikh_2	Sheikh	true
land_units_onscreen_name_ovn_arb_cha_sheikh_3	Sheikh	true
land_units_onscreen_name_ovn_arb_cha_sheikh_mehmed_0	Mehmed the Butcher	true
land_units_onscreen_name_ovn_arb_cha_sheikh_mehmed_1	Mehmed the Butcher	true
land_units_onscreen_name_ovn_arb_cha_sheikh_mehmed_2	Mehmed the Butcher	true
land_units_onscreen_name_ovn_arb_cha_sheikh_mehmed_3	Mehmed the Butcher	true
land_units_onscreen_name_ovn_arb_cha_sultan_jaffar_0	Sultan Jaffar	true
land_units_onscreen_name_ovn_arb_cha_sultan_jaffar_djinn	Sultan Jaffar	true
land_units_onscreen_name_ovn_arb_cha_vizier_desert_0	Grand Vizier (Djinn)	true
land_units_onscreen_name_ovn_arb_cha_vizier_desert_1	Grand Vizier (Djinn)	true
land_units_onscreen_name_ovn_arb_cha_vizier_desert_2	Grand Vizier (Djinn)	true
land_units_onscreen_name_ovn_arb_cha_vizier_desert_3	Grand Vizier (Djinn)	true
land_units_onscreen_name_ovn_arb_cha_vizier_fire_0	Grand Vizier (Fire)	true
land_units_onscreen_name_ovn_arb_cha_vizier_fire_1	Grand Vizier (Fire)	true
land_units_onscreen_name_ovn_arb_cha_vizier_fire_2	Grand Vizier (Fire)	true
land_units_onscreen_name_ovn_arb_cha_vizier_fire_3	Grand Vizier (Fire)	true
land_units_onscreen_name_ovn_arb_cha_vizier_heavens_0	Grand Vizier (Heavens)	true
land_units_onscreen_name_ovn_arb_cha_vizier_heavens_1	Grand Vizier (Heavens)	true
land_units_onscreen_name_ovn_arb_cha_vizier_heavens_2	Grand Vizier (Heavens)	true
land_units_onscreen_name_ovn_arb_cha_vizier_heavens_3	Grand Vizier (Heavens)	true
land_units_onscreen_name_ovn_arb_cha_vizier_life_0	Grand Vizier (Life)	true
land_units_onscreen_name_ovn_arb_cha_vizier_life_1	Grand Vizier (Life)	true
land_units_onscreen_name_ovn_arb_cha_vizier_life_2	Grand Vizier (Life)	true
land_units_onscreen_name_ovn_arb_cha_vizier_life_3	Grand Vizier (Life)	true
land_units_onscreen_name_ovn_arb_inf_alrahem_nomads	Nomad Trackers	true
land_units_onscreen_name_ovn_arb_inf_arabyan_bowmen	Bowmen	true
land_units_onscreen_name_ovn_arb_inf_arabyan_guard	Palace Guards	true
land_units_onscreen_name_ovn_arb_inf_arabyan_spearmen	Spearmen	true
land_units_onscreen_name_ovn_arb_inf_arabyan_spearmen_summoned_0	Spearmen Mirage	true
land_units_onscreen_name_ovn_arb_inf_arabyan_spearmen_summoned_1	Spearmen Mirage	true
land_units_onscreen_name_ovn_arb_inf_arabyan_warriors	Warriors	true
land_units_onscreen_name_ovn_arb_inf_corsairs	Corsairs	true
land_units_onscreen_name_ovn_arb_inf_dervishers	Dervishers	true
land_units_onscreen_name_ovn_arb_inf_arabyan_warriors_ror	Mullah Aklan'd's Death Commandos (Warriors)	true
land_units_onscreen_name_ovn_arb_inf_jezzails	Jezzails	true
land_units_onscreen_name_ovn_arb_inf_jezzails_ror	Malaluk Raiders (Jezzails)	true
land_units_onscreen_name_ovn_arb_inf_pit_fighters	Pit-Fighters	true
land_units_onscreen_name_ovn_arb_inf_sharkas_slaves	Slave Rabble	true
land_units_onscreen_name_ovn_arb_inf_southland_warriors	Southlands Warriors	true
land_units_onscreen_name_ovn_arb_mon_desert_spirit	Desert Spirit	true
land_units_onscreen_name_ovn_arb_mon_elephant	Elephants	true
land_units_onscreen_name_ovn_arb_mon_fire_efreet	Fire Efreet	true
land_units_onscreen_name_ovn_arb_mon_genie	Genie	true
land_units_onscreen_name_ovn_arb_mon_genie_summoned	Bound Genie	true
land_units_onscreen_name_ovn_arb_mon_sea_nymph	Sea Nymph	true
land_units_onscreen_name_ovn_arb_mon_tempest_djinn	Tempest Djinn	true
land_units_onscreen_name_ovn_arb_mon_war_elephant	War Elephant	true
land_units_onscreen_name_ovn_arb_mon_war_elephant_ror_1	Ravager of El-Kalabad (War Elephant)	true
land_units_onscreen_name_ovn_arb_mon_war_elephant_ror_2	Gajnal Juggernaut (War Elephant)	true
land_units_onscreen_name_ovn_arb_mon_sea_nymph_ror	The Sea-Monarch (Sea Nymph)	true
land_units_onscreen_name_ovn_arb_mon_desert_spirit_ror	Khar-mel (Desert Spirit)	true
land_units_onscreen_name_ovn_arb_mon_fire_efreet_ror	The Sultan of Flames (Fire Efreet)	true
land_units_onscreen_name_ovn_arb_mon_tempest_djinn_ror	The Raging Tempest (Tempest Djinn)	true
land_units_onscreen_name_ovn_arb_mon_desert_spirit_summoned	Bound Desert Spirit	true
land_units_onscreen_name_ovn_arb_mon_fire_efreet_summoned	Bound Fire Efreet	true
land_units_onscreen_name_ovn_arb_mon_sea_nymph_summoned	Bound Sea Nymph	true
land_units_onscreen_name_ovn_arb_mon_tempest_djinn_summoned	Bound Tempest Djinn	true
land_units_onscreen_name_ovn_arb_mon_giant_vulture_feral	Feral Giant Vulture	true
land_units_onscreen_name_ovn_arb_cav_waghzen	Waghzen	true
land_units_onscreen_name_ovn_arb_mon_enchanted_rope	Enchanted Ropes	true
land_units_onscreen_name_ovn_arb_mon_enchanted_rope_summoned	Bound Enchanted Ropes	true
land_units_onscreen_name_ovn_arb_art_naphtha_thrower	Naphtha Throwers	true
land_units_onscreen_name_ovn_arb_veh_naphtha_thrower_ror	Shihab's Animunculus (Naphtha Throwers)	true
land_units_onscreen_name_ovn_arb_cav_lancer_camels_ror	Dread Daughters of Tariq (Camel Lancers)	true
land_units_onscreen_name_ovn_arb_djinn_carriage	Djinn Carriage	true
land_units_onscreen_name_ovn_arb_inf_arabyan_guard_ror	Black Scimitar Guard (Palace Guards)	true
land_units_onscreen_name_ovn_arb_art_quadballista	Scorpions	true
land_units_onscreen_name_ovn_arb_art_quadballista_ror	Kaadiq's Wondrous Cheiroballistae (Scorpions)	true
land_units_onscreen_name_ovn_arb_mon_book_djinn	Enchanted Books	true
land_units_onscreen_name_ovn_arb_inf_naffatun_ror	The Fire-Baptised (Bowmen)	true
